27 27
6 4 4 5 12 12 12 14 12 12 13 12 12 12 12 12 12 12 12 12 12 5 8 8 8 8 8 
2 0 0 4 4 4 4 2 0 0 1 0 0 0 0 0 0 0 0 0 0 3 0 0 0 0 2 
2 0 0 12 12 13 12 12 12 12 13 12 12 12 13 12 12 12 9 8 8 13 12 13 12 12 10 
2 0 0 0 0 3 0 0 0 0 1 0 0 0 1 0 0 0 1 0 0 1 0 1 0 0 2 
2 0 0 0 0 3 0 0 0 0 1 0 0 0 1 0 0 0 1 0 0 1 0 1 0 0 2 
2 0 0 0 0 3 0 0 0 0 1 0 0 0 1 0 0 0 1 0 0 1 0 1 0 0 2 
2 0 0 0 0 11 8 8 8 8 9 0 0 0 4 4 4 4 1 0 0 1 0 1 0 0 2 
2 0 0 0 0 3 0 0 0 0 1 0 0 0 0 0 0 0 1 0 0 1 0 1 0 0 2 
2 0 0 0 0 3 0 0 0 0 1 0 0 0 0 0 0 0 1 0 0 1 0 1 0 0 2 
2 0 0 0 0 3 0 0 0 0 1 8 8 8 8 8 8 8 9 0 0 14 12 12 12 12 10 
2 0 0 0 0 3 0 0 0 0 1 0 0 0 0 0 0 0 1 0 0 1 0 0 0 0 2 
2 0 0 0 0 3 0 0 0 0 1 0 0 0 0 0 0 0 1 0 0 1 0 0 0 0 2 
2 8 8 8 8 10 8 8 8 8 9 0 0 0 0 0 0 0 1 0 0 1 0 0 0 0 2 
0 0 0 0 0 2 0 0 0 0 1 0 0 0 0 0 0 0 1 0 0 1 0 0 0 0 2 
0 0 0 0 0 2 0 0 0 0 1 0 0 0 0 0 0 0 1 0 0 1 0 0 0 0 2 
0 3 0 0 0 2 0 0 0 0 1 0 0 0 0 0 0 0 1 0 0 1 0 0 0 0 2 
0 3 0 0 0 2 0 0 0 0 1 0 0 0 0 0 0 0 1 0 0 1 0 0 0 0 2 
0 3 0 0 0 2 8 8 8 8 8 8 8 8 8 8 8 8 8 0 0 5 4 4 4 4 2 
0 3 0 0 0 0 0 0 0 0 0 0 0 0 0 0 0 0 0 0 0 7 12 12 12 12 0 
0 3 0 0 0 0 0 0 0 0 0 0 0 0 0 0 0 0 0 0 0 3 0 0 0 0 0 
0 3 0 0 0 0 0 0 1 8 8 8 8 8 8 0 0 0 0 0 0 3 0 0 0 0 0 
0 3 0 0 0 0 0 0 1 0 0 0 0 0 2 0 0 0 0 0 0 3 0 0 0 0 0 
0 3 0 0 0 0 0 0 1 0 0 0 0 0 2 0 0 0 0 0 0 3 0 0 0 0 0 
0 3 0 0 0 0 0 0 1 0 0 0 0 0 2 0 0 0 0 0 0 3 0 0 0 0 0 
0 3 0 0 0 0 0 0 1 0 0 0 0 0 2 0 0 0 0 0 0 3 0 0 0 0 0 
0 7 12 12 12 12 12 12 12 12 12 12 12 12 14 12 12 12 12 12 12 11 0 0 0 0 0 
0 0 0 0 0 0 0 0 0 0 0 0 0 0 0 0 0 0 0 0 0 0 0 0 0 0 0 
